........................................................................................................................
........................................................................................................................
........................................................................................................................
........................................................................................................................
................##########################################################################################..............
................##########################################################################################..............
................##########################################################################################..............
................##########################################################################################..............
................##########################################################################################..............
................##########################################################################################..............
................##########################################################################################..............
................##########################################################################################..............
........................................................................................................................
........................................................................................................................
........................................................................................................................
........................................................................................................................
........................................................................................................................
........................................................................................................................
........................................................................................................................
........................................................................................................................
........................................................................................................................
........................................................................................................................
........................................................................................................................
........................................................................................................................
........................................................................................................................
........................................................................................................................
........................................................................................................................
........................................................................................................................
...........####################################################################################################.........
........................................................................................................................
........................................................................................................................
........................................................................................................................
...........####################################################################################################.........
........................................................................................................................
........................................................................................................................
........................................................................................................................
...........####################################################################################################.........
........................................................................................................................
........................................................................................................................
........................................................................................................................
...........####################################################################################################.........
........................................................................................................................
........................................................................................................................
........................................................................................................................
...........####################################################################################################.........
........................................................................................................................
........................................................................................................................
........................................................................................................................
........................................................................................................................
........................................................................................................................
........................................................................................................................
........................................................................................................................
........................................................................................................................
........................................................................................................................
...........####################################################################################################.........
........................................................................................................................
........................................................................................................................
........................................................................................................................
...........####################################################################################################.........
........................................................................................................................
........................................................................................................................
........................................................................................................................
...........####################################################################################################.........
........................................................................................................................
........................................................................................................................
........................................................................................................................
...........####################################################################################################.........
........................................................................................................................
........................................................................................................................
........................................................................................................................
...........####################################################################################################.........
........................................................................................................................
........................................................................................................................
........................................................................................................................
........................................................................................................................
........................................................................................................................
........................................................................................................................
........................................................................................................................
........................................................................................................................
........................................................................................................................
........................................................................................................................
........................................................................................................................
........................................................................................................................
........................................................................................................................
........................................................................................................................
........................................................................................................................
........................................................................................................................
........................................................................................................................
........................................................................................................................
........................................................................................................................
........................................................................................................................
........................................................................................................................
........................................................................................................................
........................................................................................................................
........................................................................................................................
........................................................................................................................
